000000000000004
2DDDDDB000000D3
000000B0000DDH0
000000B0000H000
000000DDDDDH000
000000000000000
000000000000000
